# # ########### ###
# #         #     #
####### ### # #####
    #   #   # #   #
### ############# #
# # #           #  
# # ##### ####### #
  # #     #   #   #
####### ### #######
#           # #    
# ##### ##### #####
# #   #     #      
##### # ### ##### #
  #   # #     #   #
##### ##### # #####
# # #     # #   #  
# # ##### ### #####
    # #   # #     #
##### # ### # #####
