                    #######################
               #################################
           #######   #     #       #    #    #######
        #######   ###      ##     ##     ###   #######
      ######   #####       #########      #####    #####
    ######  ########       #########       ######    #####
   ####   ##########       #########       #########   #####
  ####  ##############    ###########     ############   ####
 ####  #################################################  ####
####  ###################################################  ####
####  ####################################################  ####
####  ####################################################  ####
 ####  ###################################################  ####
  ####  #######     ####  ###########  ####     #########  ####
   ####   #####      #      #######      #      ########  ####
    #####   ####             #####             ######   #####
      #####   ##              ###              ##    ######
       ######   #              #              #   #######
         #######                                #######
            ########                         #######
               #################################
                    #######################
