#####################
#                   #
# ################# #
# #               # #
# # ############# # #
# # #           # # #
# # # ######### # # #
# # # #   #   # # # #
# # # # ##### # # # #
# # # # #   # # # # #
### # # ### # ### # #
# # # # #   # # # # #
# # # # ##### # # # #
# # # #       # # # #
# # # ######### # # #
# # #           # # #
# # ############# # #
# #       #       # #
# ################# #
#                   #
#####################
