   ####  ####
  ###   ######
 ###  #########
 ####      ####
 #########  ###
  ######   ###
   ####  ####
